000000000000000000000000000000000000000
000000000000110000000000011000000000000
000000000000110000000000011000000000000
000000000000000000000000000000000000000
000000000000000000000000000000000000000
000000010000000000000000000000010000000
000000101000001000000000100000101000000
000001001000001011000110100000100100000
000000110000000000101000000000011000000
000000000000000010101010000000000000000
000000000000000001000100000000000000000
000000000000000000000000000000000000000
011000000000000000000000000000000000110
011000000000000000000000000000000000110
000000110000000000000000000000011000000
000000000000000000000000000000000000000
000000010100000000000000000001010000000
000000010010000000000000000010010000000
000000001100000000000000000001100000000
000000000000000000000000000000000000000
000000001100000000000000000001100000000
000000010010000000000000000010010000000
000000010100000000000000000001010000000
000000000000000000000000000000000000000
000000110000000000000000000000011000000
011000000000000000000000000000000000110
011000000000000000000000000000000000110
000000000000000000000000000000000000000
000000000000000001000100000000000000000
000000000000000010101010000000000000000
000000110000000000101000000000011000000
000001001000001011000110100000100100000
000000101000001000000000100000101000000
000000010000000000000000000000010000000
000000000000000000000000000000000000000
000000000000000000000000000000000000000
000000000000110000000000011000000000000
000000000000110000000000011000000000000
000000000000000000000000000000000000000
