00000000000000000000000000000000000000000000000000
00000000000000000000000000000000000000000000000000
01100011000110001100011000110001100011000110001100
00011000110001100011000110001100011000110001100011
00011000110001100011000110001100011000110001100011
01100011000110001100011000110001100011000110001100
00000000000000000000000000000000000000000000000000
00000000000000000000000000000000000000000000000000
11000110001100011000110001100011000110001100011000
00011000110001100011000110001100011000110001100011
00011000110001100011000110001100011000110001100011
11000110001100011000110001100011000110001100011000
00000000000000000000000000000000000000000000000000
00000000000000000000000000000000000000000000000000
01100011000110001100011000110001100011000110001100
00011000110001100011000110001100011000110001100011
00011000110001100011000110001100011000110001100011
01100011000110001100011000110001100011000110001100
00000000000000000000000000000000000000000000000000
00000000000000000000000000000000000000000000000000
11000110001100011000110001100011000110001100011000
00011000110001100011000110001100011000110001100011
00011000110001100011000110001100011000110001100011
11000110001100011000110001100011000110001100011000
00000000000000000000000000000000000000000000000000
00000000000000000000000000000000000000000000000000
01100011000110001100011000110001100011000110001100
00011000110001100011000110001100011000110001100011
00011000110001100011000110001100011000110001100011
01100011000110001100011000110001100011000110001100
00000000000000000000000000000000000000000000000000
00000000000000000000000000000000000000000000000000
11000110001100011000110001100011000110001100011000
00011000110001100011000110001100011000110001100011
00011000110001100011000110001100011000110001100011
11000110001100011000110001100011000110001100011000
00000000000000000000000000000000000000000000000000
00000000000000000000000000000000000000000000000000
01100011000110001100011000110001100011000110001100
00011000110001100011000110001100011000110001100011
00011000110001100011000110001100011000110001100011
01100011000110001100011000110001100011000110001100
00000000000000000000000000000000000000000000000000
00000000000000000000000000000000000000000000000000
11000110001100011000110001100011000110001100011000
00011000110001100011000110001100011000110001100011
00011000110001100011000110001100011000110001100011
11000110001100011000110001100011000110001100011000
00000000000000000000000000000000000000000000000000
00000000000000000000000000000000000000000000000000
